F 69,75,27
C 135,206,235

NO ./textures/north.png
SO ./textures/south.png
WE ./textures/west.png
EA ./textures/east.png

    1111111111111111111
    1101001001001001011
    1001001001001001001
1001001001001001001
1001001000001001001
100000000N000000001
1000011111111000001
1111000000000001111
1000000101010000001
1111111111111111111
