F 139,99,58
C 171,154,137

NO ./textures/north.png
SO ./textures/south.png
WE ./textures/west.png
EA ./textures/east.png

1111111111111111111111111111
1S0000000000000000000000001
111111111111111111111111111
          1111111111111111111